//MAP CONVERTED BY dmm2tgm.py THIS HEADER COMMENT PREVENTS RECONVERSION, DO NOT REMOVE
"aa" = (
/turf/unsimulated/wall/auto/adventure/shuttle/dark,
/area/evilreaver/storage/engineering{
	name = "GLOMAR Salvager"
	})
"ab" = (
/turf/variableTurf/clear,
/area/space)
"ac" = (
/obj/machinery/door/airlock/pyro/external,
/turf/simulated/floor/plating/damaged2,
/area/evilreaver/storage/engineering{
	name = "GLOMAR Salvager"
	})
"ad" = (
/turf/simulated/floor/plating/damaged2,
/area/evilreaver/storage/engineering{
	name = "GLOMAR Salvager"
	})
"ae" = (
/obj/machinery/drainage,
/obj/item/clothing/suit/space/engineer/april_fools,
/obj/item/clothing/head/helmet/space/engineer/april_fools,
/turf/simulated/floor/plating/damaged2,
/area/evilreaver/storage/engineering{
	name = "GLOMAR Salvager"
	})
"af" = (
/obj/disposalpipe/segment{
	dir = 4;
	icon_state = "pipe-c"
	},
/turf/simulated/floor/plating/scorched,
/area/evilreaver/storage/engineering{
	name = "GLOMAR Salvager"
	})
"ag" = (
/obj/machinery/manufacturer/robotics,
/obj/disposalpipe/segment{
	dir = 2;
	icon_state = "pipe-c"
	},
/turf/simulated/floor/plating/scorched,
/area/evilreaver/storage/engineering{
	name = "GLOMAR Salvager"
	})
"ah" = (
/obj/disposalpipe/segment{
	dir = 2;
	icon_state = "pipe-c"
	},
/turf/simulated/floor/plating/scorched,
/area/evilreaver/storage/engineering{
	name = "GLOMAR Salvager"
	})
"ai" = (
/obj/item/cell/cerenkite/charged,
/obj/disposalpipe/segment{
	dir = 4;
	icon_state = "pipe-c"
	},
/turf/simulated/floor/plating/scorched,
/area/evilreaver/storage/engineering{
	name = "GLOMAR Salvager"
	})
"aj" = (
/obj/machinery/disposal,
/obj/disposalpipe/trunk,
/turf/simulated/floor/plating/scorched,
/area/evilreaver/storage/engineering{
	name = "GLOMAR Salvager"
	})
"ak" = (
/obj/landmark/artifact,
/turf/simulated/floor/plating/scorched,
/area/evilreaver/storage/engineering{
	name = "GLOMAR Salvager"
	})
"al" = (
/turf/simulated/floor/plating/scorched,
/area/evilreaver/storage/engineering{
	name = "GLOMAR Salvager"
	})
"am" = (
/obj/machinery/crusher,
/obj/disposalpipe/segment,
/turf/simulated/floor/plating/scorched,
/area/evilreaver/storage/engineering{
	name = "GLOMAR Salvager"
	})
"an" = (
/obj/disposalpipe/segment,
/turf/simulated/floor/plating/damaged2,
/area/evilreaver/storage/engineering{
	name = "GLOMAR Salvager"
	})
"ao" = (
/obj/item/secbot_assembly,
/obj/disposalpipe/segment,
/turf/simulated/floor/plating/scorched,
/area/evilreaver/storage/engineering{
	name = "GLOMAR Salvager"
	})
"ap" = (
/obj/item/bananapeel,
/obj/disposalpipe/segment,
/turf/simulated/floor/plating/scorched,
/area/evilreaver/storage/engineering{
	name = "GLOMAR Salvager"
	})
"aq" = (
/obj/machinery/conveyor/WE{
	name = "salvage belt - east";
	operating = 1
	},
/turf/simulated/floor/plating/scorched,
/area/evilreaver/storage/engineering{
	name = "GLOMAR Salvager"
	})
"ar" = (
/obj/machinery/conveyor/WE{
	name = "salvage belt - east";
	operating = 1
	},
/obj/disposalpipe/segment,
/turf/simulated/floor/plating/scorched,
/area/evilreaver/storage/engineering{
	name = "GLOMAR Salvager"
	})
"as" = (
/obj/landmark/artifact,
/obj/disposalpipe/segment,
/turf/simulated/floor/plating/damaged2,
/area/evilreaver/storage/engineering{
	name = "GLOMAR Salvager"
	})
"at" = (
/obj/machinery/conveyor/EW{
	name = "salvage belt - west";
	operating = 1
	},
/obj/disposalpipe/segment,
/turf/simulated/floor/plating/scorched,
/area/evilreaver/storage/engineering{
	name = "GLOMAR Salvager"
	})
"au" = (
/obj/machinery/bot/secbot{
	control_freq = 0
	},
/obj/machinery/conveyor/EW{
	name = "salvage belt - west";
	operating = 1
	},
/obj/disposalpipe/segment,
/turf/simulated/floor/plating/scorched,
/area/evilreaver/storage/engineering{
	name = "GLOMAR Salvager"
	})
"av" = (
/obj/machinery/crusher,
/turf/simulated/floor/plating/scorched,
/area/evilreaver/storage/engineering{
	name = "GLOMAR Salvager"
	})
"aw" = (
/obj/machinery/bot/secbot{
	control_freq = 0
	},
/obj/disposalpipe/segment,
/turf/simulated/floor/plating/scorched,
/area/evilreaver/storage/engineering{
	name = "GLOMAR Salvager"
	})
"ax" = (
/obj/disposalpipe/segment,
/turf/simulated/floor/plating/scorched,
/area/evilreaver/storage/engineering{
	name = "GLOMAR Salvager"
	})
"ay" = (
/obj/item/cell/charged,
/turf/simulated/floor/plating/scorched,
/area/evilreaver/storage/engineering{
	name = "GLOMAR Salvager"
	})
"az" = (
/obj/machinery/neosmelter,
/turf/simulated/floor/plating/scorched,
/area/evilreaver/storage/engineering{
	name = "GLOMAR Salvager"
	})
"aA" = (
/obj/disposalpipe/segment,
/obj/item/clothing/suit/space/industrial,
/obj/item/sea_ladder,
/turf/simulated/floor/plating/scorched,
/area/evilreaver/storage/engineering{
	name = "GLOMAR Salvager"
	})
"aB" = (
/obj/item/cell/charged,
/obj/disposalpipe/segment,
/turf/simulated/floor/plating/scorched,
/area/evilreaver/storage/engineering{
	name = "GLOMAR Salvager"
	})
"aC" = (
/obj/table,
/turf/simulated/floor/plating/scorched,
/area/evilreaver/storage/engineering{
	name = "GLOMAR Salvager"
	})
"aD" = (
/obj/npc/trader/robot{
	name = "Thrifty B.O.B.";
	picture = "loungebuddy.png";
	trader_area = "/area/evilreaver/storage/engineering"
	},
/obj/map/light/white,
/turf/simulated/floor/plating/scorched,
/area/evilreaver/storage/engineering{
	name = "GLOMAR Salvager"
	})
"aE" = (
/obj/machinery/manufacturer/mechanic,
/obj/disposalpipe/segment,
/turf/simulated/floor/plating/scorched,
/area/evilreaver/storage/engineering{
	name = "GLOMAR Salvager"
	})
"aF" = (
/obj/machinery/manufacturer/general,
/obj/disposalpipe/segment,
/turf/simulated/floor/plating/scorched,
/area/evilreaver/storage/engineering{
	name = "GLOMAR Salvager"
	})
"aG" = (
/obj/machinery/processor,
/turf/simulated/floor/plating/scorched,
/area/evilreaver/storage/engineering{
	name = "GLOMAR Salvager"
	})
"aH" = (
/obj/marker/supplymarker,
/turf/simulated/floor/plating/scorched,
/area/evilreaver/storage/engineering{
	name = "GLOMAR Salvager"
	})
"aI" = (
/obj/disposalpipe/segment{
	dir = 1;
	icon_state = "pipe-c"
	},
/turf/simulated/floor/plating/scorched,
/area/evilreaver/storage/engineering{
	name = "GLOMAR Salvager"
	})
"aJ" = (
/obj/disposalpipe/segment{
	dir = 8;
	icon_state = "pipe-c"
	},
/turf/simulated/floor/plating/scorched,
/area/evilreaver/storage/engineering{
	name = "GLOMAR Salvager"
	})
"aK" = (
/obj/item/ore_scoop,
/obj/disposalpipe/segment{
	dir = 1;
	icon_state = "pipe-c"
	},
/turf/simulated/floor/plating/scorched,
/area/evilreaver/storage/engineering{
	name = "GLOMAR Salvager"
	})
"aL" = (
/obj/machinery/conveyor/EW{
	name = "salvage belt - west";
	operating = 1
	},
/obj/disposalpipe/segment,
/obj/item/device/gps{
	identifier = "W8ST"
	},
/turf/simulated/floor/plating/scorched,
/area/evilreaver/storage/engineering{
	name = "GLOMAR Salvager"
	})
"aM" = (
/obj/disposalpipe/segment,
/obj/item/clothing/suit/space/industrial,
/obj/item/sea_ladder,
/obj/mapping_helper/turfs/burner,
/turf/simulated/floor/plating,
/area/evilreaver/storage/engineering{
	name = "GLOMAR Salvager"
	})
"aN" = (
/obj/machinery/processor,
/obj/mapping_helper/turfs/burner,
/turf/simulated/floor/plating,
/area/evilreaver/storage/engineering{
	name = "GLOMAR Salvager"
	})
"aO" = (
/obj/machinery/manufacturer/mechanic,
/obj/disposalpipe/segment,
/obj/mapping_helper/turfs/burner,
/turf/simulated/floor/plating,
/area/evilreaver/storage/engineering{
	name = "GLOMAR Salvager"
	})
"aP" = (
/obj/item/ore_scoop,
/obj/disposalpipe/segment{
	dir = 1;
	icon_state = "pipe-c"
	},
/obj/mapping_helper/turfs/burner,
/turf/simulated/floor/plating,
/area/evilreaver/storage/engineering{
	name = "GLOMAR Salvager"
	})
"aQ" = (
/obj/mapping_helper/turfs/damager,
/turf/simulated/floor/plating,
/area/evilreaver/storage/engineering{
	name = "GLOMAR Salvager"
	})
"aR" = (
/obj/disposalpipe/segment{
	dir = 8;
	icon_state = "pipe-c"
	},
/obj/mapping_helper/turfs/burner,
/turf/simulated/floor/plating,
/area/evilreaver/storage/engineering{
	name = "GLOMAR Salvager"
	})
"aS" = (
/obj/disposalpipe/segment,
/obj/mapping_helper/turfs/burner,
/turf/simulated/floor/plating,
/area/evilreaver/storage/engineering{
	name = "GLOMAR Salvager"
	})
"aT" = (
/obj/npc/trader/robot{
	name = "Thrifty B.O.B.";
	picture = "loungebuddy.png";
	trader_area = "/area/evilreaver/storage/engineering"
	},
/obj/map/light/white,
/obj/mapping_helper/turfs/burner,
/turf/simulated/floor/plating,
/area/evilreaver/storage/engineering{
	name = "GLOMAR Salvager"
	})
"aU" = (
/obj/mapping_helper/turfs/burner,
/turf/simulated/floor/plating,
/area/evilreaver/storage/engineering{
	name = "GLOMAR Salvager"
	})
"aV" = (
/obj/machinery/manufacturer/general,
/obj/disposalpipe/segment,
/obj/mapping_helper/turfs/burner,
/turf/simulated/floor/plating,
/area/evilreaver/storage/engineering{
	name = "GLOMAR Salvager"
	})
"aW" = (
/obj/item/cell/charged,
/obj/disposalpipe/segment,
/obj/mapping_helper/turfs/burner,
/turf/simulated/floor/plating,
/area/evilreaver/storage/engineering{
	name = "GLOMAR Salvager"
	})
"aX" = (
/obj/disposalpipe/segment,
/obj/mapping_helper/turfs/damager,
/turf/simulated/floor/plating,
/area/evilreaver/storage/engineering{
	name = "GLOMAR Salvager"
	})
"aY" = (
/obj/marker/supplymarker,
/obj/mapping_helper/turfs/burner,
/turf/simulated/floor/plating,
/area/evilreaver/storage/engineering{
	name = "GLOMAR Salvager"
	})
"aZ" = (
/obj/disposalpipe/segment{
	dir = 1;
	icon_state = "pipe-c"
	},
/obj/mapping_helper/turfs/burner,
/turf/simulated/floor/plating,
/area/evilreaver/storage/engineering{
	name = "GLOMAR Salvager"
	})
"bm" = (
/obj/item/cell/cerenkite/charged,
/obj/disposalpipe/segment{
	dir = 4;
	icon_state = "pipe-c"
	},
/obj/mapping_helper/turfs/burner,
/turf/simulated/floor/plating,
/area/evilreaver/storage/engineering{
	name = "GLOMAR Salvager"
	})
"eK" = (
/obj/disposalpipe/segment,
/obj/mapping_helper/turfs/damager,
/obj/landmark/spawner/artifact,
/turf/simulated/floor/plating,
/area/evilreaver/storage/engineering{
	name = "GLOMAR Salvager"
	})
"fD" = (
/obj/machinery/disposal,
/obj/disposalpipe/trunk,
/obj/mapping_helper/turfs/burner,
/turf/simulated/floor/plating,
/area/evilreaver/storage/engineering{
	name = "GLOMAR Salvager"
	})
"fU" = (
/obj/machinery/crusher,
/obj/mapping_helper/turfs/burner,
/turf/simulated/floor/plating,
/area/evilreaver/storage/engineering{
	name = "GLOMAR Salvager"
	})
"ho" = (
/obj/table,
/obj/mapping_helper/turfs/burner,
/turf/simulated/floor/plating,
/area/evilreaver/storage/engineering{
	name = "GLOMAR Salvager"
	})
"iM" = (
/obj/machinery/conveyor/WE{
	name = "salvage belt - east";
	operating = 1
	},
/obj/mapping_helper/turfs/burner,
/turf/simulated/floor/plating,
/area/evilreaver/storage/engineering{
	name = "GLOMAR Salvager"
	})
"jg" = (
/obj/machinery/manufacturer/robotics,
/obj/disposalpipe/segment{
	dir = 2;
	icon_state = "pipe-c"
	},
/obj/mapping_helper/turfs/burner,
/turf/simulated/floor/plating,
/area/evilreaver/storage/engineering{
	name = "GLOMAR Salvager"
	})
"jx" = (
/obj/item/secbot_assembly,
/obj/disposalpipe/segment,
/obj/mapping_helper/turfs/burner,
/turf/simulated/floor/plating,
/area/evilreaver/storage/engineering{
	name = "GLOMAR Salvager"
	})
"lx" = (
/obj/machinery/drainage,
/obj/item/clothing/suit/space/engineer/april_fools,
/obj/item/clothing/head/helmet/space/engineer/april_fools,
/obj/mapping_helper/turfs/damager,
/turf/simulated/floor/plating,
/area/evilreaver/storage/engineering{
	name = "GLOMAR Salvager"
	})
"nP" = (
/obj/disposalpipe/segment{
	dir = 2;
	icon_state = "pipe-c"
	},
/obj/mapping_helper/turfs/burner,
/turf/simulated/floor/plating,
/area/evilreaver/storage/engineering{
	name = "GLOMAR Salvager"
	})
"tg" = (
/obj/machinery/conveyor/EW{
	name = "salvage belt - west";
	operating = 1
	},
/obj/disposalpipe/segment,
/obj/item/device/gps{
	identifier = "W8ST"
	},
/obj/mapping_helper/turfs/burner,
/turf/simulated/floor/plating,
/area/evilreaver/storage/engineering{
	name = "GLOMAR Salvager"
	})
"tG" = (
/obj/item/cell/charged,
/obj/mapping_helper/turfs/burner,
/turf/simulated/floor/plating,
/area/evilreaver/storage/engineering{
	name = "GLOMAR Salvager"
	})
"xv" = (
/obj/machinery/bot/secbot{
	control_freq = 0
	},
/obj/disposalpipe/segment,
/obj/mapping_helper/turfs/burner,
/turf/simulated/floor/plating,
/area/evilreaver/storage/engineering{
	name = "GLOMAR Salvager"
	})
"Cn" = (
/obj/machinery/conveyor/WE{
	name = "salvage belt - east";
	operating = 1
	},
/obj/disposalpipe/segment,
/obj/mapping_helper/turfs/burner,
/turf/simulated/floor/plating,
/area/evilreaver/storage/engineering{
	name = "GLOMAR Salvager"
	})
"Dw" = (
/obj/disposalpipe/segment{
	dir = 4;
	icon_state = "pipe-c"
	},
/obj/mapping_helper/turfs/burner,
/turf/simulated/floor/plating,
/area/evilreaver/storage/engineering{
	name = "GLOMAR Salvager"
	})
"Fl" = (
/obj/machinery/crusher,
/obj/disposalpipe/segment,
/obj/mapping_helper/turfs/burner,
/turf/simulated/floor/plating,
/area/evilreaver/storage/engineering{
	name = "GLOMAR Salvager"
	})
"MH" = (
/obj/item/bananapeel,
/obj/disposalpipe/segment,
/obj/mapping_helper/turfs/burner,
/turf/simulated/floor/plating,
/area/evilreaver/storage/engineering{
	name = "GLOMAR Salvager"
	})
"Nu" = (
/obj/machinery/door/airlock/pyro/external,
/obj/mapping_helper/turfs/damager,
/turf/simulated/floor/plating,
/area/evilreaver/storage/engineering{
	name = "GLOMAR Salvager"
	})
"Oz" = (
/obj/machinery/bot/secbot{
	control_freq = 0
	},
/obj/machinery/conveyor/EW{
	name = "salvage belt - west";
	operating = 1
	},
/obj/disposalpipe/segment,
/obj/mapping_helper/turfs/burner,
/turf/simulated/floor/plating,
/area/evilreaver/storage/engineering{
	name = "GLOMAR Salvager"
	})
"OD" = (
/obj/machinery/neosmelter,
/obj/mapping_helper/turfs/burner,
/turf/simulated/floor/plating,
/area/evilreaver/storage/engineering{
	name = "GLOMAR Salvager"
	})
"VP" = (
/obj/mapping_helper/turfs/burner,
/obj/landmark/spawner/artifact,
/turf/simulated/floor/plating,
/area/evilreaver/storage/engineering{
	name = "GLOMAR Salvager"
	})
"ZI" = (
/obj/machinery/conveyor/EW{
	name = "salvage belt - west";
	operating = 1
	},
/obj/disposalpipe/segment,
/obj/mapping_helper/turfs/burner,
/turf/simulated/floor/plating,
/area/evilreaver/storage/engineering{
	name = "GLOMAR Salvager"
	})

(1,1,1) = {"
ab
ab
ab
ab
ab
ab
ab
ab
ab
ab
ab
ab
ab
"}
(2,1,1) = {"
ab
ab
ab
aa
aa
aa
aa
aa
aa
aa
aa
aa
ab
"}
(3,1,1) = {"
ab
ab
ab
aa
Dw
Fl
iM
fU
aU
aT
aY
aa
ab
"}
(4,1,1) = {"
ab
ab
ab
aa
jg
aX
Cn
xv
aS
aS
aZ
aa
ab
"}
(5,1,1) = {"
ab
ab
ab
aa
Dw
jx
Cn
MH
aM
aX
aR
aa
ab
"}
(6,1,1) = {"
ab
ab
ab
aa
nP
Fl
eK
Fl
aW
aS
aP
aa
ab
"}
(7,1,1) = {"
ab
ab
ab
aa
bm
aX
tg
aS
aS
aO
aR
aa
ab
"}
(8,1,1) = {"
ab
ab
ab
aa
nP
MH
Oz
aS
aS
aV
aZ
aa
ab
"}
(9,1,1) = {"
ab
ab
ab
aa
fD
Fl
ZI
Fl
MH
aX
aR
aa
ab
"}
(10,1,1) = {"
ab
ab
ab
aa
VP
aU
aU
tG
VP
aQ
aU
aa
ab
"}
(11,1,1) = {"
ab
ab
ab
aa
aU
aU
aQ
OD
aU
aU
aU
aa
ab
"}
(12,1,1) = {"
ab
aa
aa
aa
aU
aU
aU
aU
ho
aN
aU
aa
ab
"}
(13,1,1) = {"
ab
Nu
aQ
Nu
aQ
aU
aU
aU
aU
aU
aU
aa
ab
"}
(14,1,1) = {"
ab
aa
lx
aa
aa
aa
aa
aa
aa
aa
aa
aa
ab
"}
(15,1,1) = {"
ab
aa
aa
aa
ab
ab
ab
ab
ab
ab
ab
ab
ab
"}
(16,1,1) = {"
ab
ab
ab
ab
ab
ab
ab
ab
ab
ab
ab
ab
ab
"}
